##########################################
##.....#.....#...................#.......#
#...##.......#..........#####...........##
##........#####..........................#
#.............#####................#######
#..................##...#####............#
#######..#####............#####..........#
#.##..#.........#####......#####.........#
#.#........#####.........................#
#.............#.....#####.....#.....######
#......#####..................#..#.......#
##########################################